#############################################################################
▓ ▄▄ ▄▄ ▄▄                                                         ▄▄ ▄▄ ▄▄ ▓
▓▓  ▓  ▓  ▓                                                       ▓  ▓  ▓  ▓▓
▓▓  ▓  ▓  ▓                                                       ▓  ▓  ▓  ▓▓
▓▓  ▓  ▓  ▓                                                       ▓  ▓  ▓  ▓▓
▓▓  ▓  ▓  ▓                                                       ▓  ▓  ▓  ▓▓
▓▓  ▓  ▓  ▓                                                       ▓  ▓  ▓  ▓▓
▓▓  ▓  ▓  ▓                                                       ▓  ▓  ▓  ▓▓
▓▓  ▓  ▓  ▓                                                       ▓  ▓  ▓  ▓▓
▓▓  ▓  ▓  ▓▄▄▄▄▄▄▄▄▄▄▄▄▄▄▄▄▄▄▄▄▄▄▄▄▄▄▄▄▄▄▄▄▄▄▄▄▄▄▄▄▄▄▄▄▄▄▄▄▄▄▄▄▄▄▄▓  ▓  ▓  ▓▓
#############################################################################