#############################################################################
▓ ▄▄ ▄▄ ▄▄                                                         ▄▄ ▄▄ ▄▄ ▓
▓▓  ▓  ▓  ▓                                                       ▓  ▓  ▓  ▓▓
▓▓  ▓  ▓  ▓                                                       ▓  ▓  ▓  ▓▓
▓▓  ▓  ▓  ▓                                                       ▓  ▓  ▓  ▓▓
▓▓  ▓  ▓  ▓                          b|R                            ▓  ▓  ▓  ▓▓
▓▓  ▓  ▓  ▓                         ▄▄▄                           ▓  ▓  ▓  ▓▓
▓▓  ▓  ▓  ▓                         -█-                           ▓  ▓  ▓  ▓▓
▓▓  ▓  ▓  ▓                          r█R                            ▓  ▓  ▓  ▓▓
▓▓  ▓  ▓  ▓▄▄▄▄▄▄▄▄▄▄▄▄▄▄▄▄▄▄▄▄▄▄▄▄▄▄▼▄▄▄▄▄▄▄▄▄▄▄▄▄▄▄▄▄▄▄▄▄▄▄▄▄▄▄▄▓  ▓  ▓  ▓▓
#############################################################################