#############################################################################
#         oWR                                                    oWR            #
#         |                     ┌┐                             |            #
#         |                    ┌  ┐                            |            #
#                              │l░░R│                                         #
#                              └──┘                                         #
#                       ┌────────────────┐                                  #
#                       │                │                                  #
#                       │                │                                  #
#                       │                │                                  #
#############################################################################