#############################################################################
#                               ╔════════════╗                              #
#                               ║▓▓◥█████▓▓▓ ║                              #
#                               ║    ◥███    ║                              #
#                               ║      ◥█    ║                              #
#                               ║       ◥    ║                              #
#                               ║            ║                              #
#                               ║┌┐  ┌──┐  ┌┐║                              #
#                               ║└┘  └──┘  └┘║                              #
#                               ╚════════════╝                              #
#############################################################################