#############################################################################
▓▓▓▓▓▓▓▓                ▓▓▓▓▓▓▓▓b◀------R ▓▓▓▓▓▓▓▓                     ▓▓▓▓▓▓▓▓
[][][][]                 [][][]          [][][]                      [][][][]
[][][][]                 [][][]          [][][]                      [][][][]
[][][][]                 [][][]          [][][]                      [][][][]
[][][][]                 [][][]          [][][]                      [][][][]
[][][][]                 [][][]          [][][]                      [][][][]
[][][][]                 [][][]          [][][]                      [][][][]
[][][][]                 [][][]          [][][]                      [][][][]
▓▓▓▓▓▓▓▓                ▓▓▓▓▓▓▓▓        ▓▓▓▓▓▓▓▓                     ▓▓▓▓▓▓▓▓
#############################################################################