#############################################################################
#                                                                           #
#                           ┌       ┐                                       #
#                           │r░░░░░░░R│                                       #
#                           │r░░░░░░░R│                                       #
#                           └───────┘                                       #
#                       ┌────────────────┐                                  #
#                       │                │                                  #
#                       │                │                                  #
#                       │                │                                  #
#############################################################################