#############################################################################
#                                                                           #
#                            ________                                       #
#                           /████████\\=======8                             #
#                           \████████/                                      #
#                            ────────                                       #
#                       ┌────────────────┐                                  #
#                       │                │                                  #
#                       │                │                                  #
#                       │                │                                  #
#############################################################################