#############################################################################
#                                                                           #
#        ┌┐                     ┌┐                                          #
#       ┌  ┐                   ┌  ┐                                         #
#       │l░░R│                   │l░░R│                                         #
#       └──┘                   └──┘                                         #
# ┌────────────────┐    ┌────────────────┐       ┌────────────────┐         #
# │                │    │                │       │                │         #
# │                │    │                │       │                │         #
# │                │    │                │       │                │         #
#############################################################################