#############################################################################
#                                                                           #
#                                                                           #
#                             ◢◣                                            #
#                             ◥◤                                            #
#                        ◢╦═══╣╠═══╦◣                                       #
#                          ║╚═║║═╝ ║                                        #
#                         ▓█▓ ║║   ║                                        #
#                         ◥┼◤                                               #
#                            ◢║║◣                                           #
#############################################################################